+------+---+----------+ 
|   8  | G |3       4 |
| 9-+  |   |   +---   |
+-  |  +- -+   |   5  |
|   |  | 1  2  |**   *|
|*  |  +-------+-   --+
|   | 7            6  |
+-  +-+---------------+
|*    |               |
|*    +---------------+
|    *|                     
+- F -+                  
