     +------+
     |      |
+----+      |
|    |      |            
|    |  G   |            
|           +-------+
+----               |
|               1   |
+------------+      |
             |      |
             |   |  |
             |  -+- |
             |   |  |
+------------+   +--+
|             2  | 6     F
|                |  
| 3 -------------+  |
|                  5|
+-------------------+