     +------+
     |      |
+----+      |
|    |      |            
|    |  G   |            
|           +-------+
+----               |
|              1 G  |
+------------+      |
             |      |
             |   |  |
             |  -+--+
             |   |  |
+------------+   +--+
|             2  |  6    F
| 3              |  
|   -------------+  |
|  4              5 |
+-------------------+