     +------+
     |      |
-----|      |-------------
|    |  G   |   |        |
|    |      |            |
|                        |
|                        |
|                        |
|-     +-------+         |
|      |                 |
|      |            F    |
|            |           |
|            |           |
|-----  ---              |
|                        |
|                        |
|             -----+     |
|                         
+------------------------+